NO img/path_to_the_north_texture
SO img/path_to_the_south_texture
WE img/path_to_the_west_texture
EA img/path_to_the_east_texture






F 250,155,54



C 225,30,4


11111111111
10000000011
100000S0001
11111100001
11111111111
