EA ./path_to_the_east_texture
SO ./path_to_the_south_texture
WE ./path_to_the_west_texture



NO ./path_to_the_north_texture














F 220,100,0










C 225,30,0



    111111
100001111111111
100001
10000111
111111
W E N S 0 1