NO ./path_to_the_north_texture
SO ./path_to/the_south_texture
WE ./path_to_the_west_texture
EA ./path_to_the_east_texture

F 250,155,6
C 225,30,0

    1111111111111111111111111
    1000000000110000000000001
    1011000001110000000000001
    1001000000000000000000001
111111111011000001110000000001111
100000000011000001110111111111111
11110111111111011100000010001
111101111101110E1101010010001
11000000110101011100000000001
1000000000010001100000010001
10000000000000001101010010001
1100000111010101111101111000111
11110111 1110101 101111010001
11111111 1111011 111111111111
