NO img/path_to_the_north_texture.xpm
SO img/path_to_the_south_texture.xpm
WE img/path_to_the_west_texture.xpm
EA img/path_to_the_east_texture.xpm

F 250,155,99
C 215,30,253

        1111111111111111111111111
        1000000000110000000000001                       
        1011000001110000000000001               
        1001000000000000000000001                       
111111111011000001110000000000001
100000000011000001110111110111111
111101111111110111N1000010001
11110111111111011111010010001
11000000110101011100000010001
10000000000000001100000000001
10000000000000001101010000101
11000001110101011111011101001
11110111 1110101 101111010001
11111111 1111111 111111111111