NO img/path_to_the_north_texture
SO img/path_to/the_south_texture
WE img/path_to_the_west_texture
EA img/path_to_the_east_texture






F 250,155,54



C 225,30,4


11111111111
1000000W111
11111100001
11111111111
