NO img/path_to_the_north_texture.xpm
SO img/path_to_the_south_texture.xpm
WE img/path_to_the_west_texture.xpm
EA img/path_to_the_east_texture.xpm


F 250,155,99
C 215,30,44



1111 11
11W010000
101110000
000000000
0000000000\n