NO img/path_to_the_north_texture.xpm
SO img/path_to_the_south_texture.xpm
WE img/path_to_the_west_texture.xpm
EA img/path_to_the_east_texture.xpm

F 250,155,99
C 215,30,253

11111111111
10000000001
10000010001
10000000001
10000N00001
11111111111